...................................................#................................................................................#.................
..............................####................................#....................................#...........................########...........
.........#..................######.....#.........................###.......##########.................###.......###......#####################.......#
....###..........####........#####....####......................#####.....#############...........##################.....#################..#########.
...###..........########.....######..#####............#.......#######....#################.......###################.....##############......#########
....##.......############....##############............##############....###############################..###########....#############...........#####
...#.........#############..#################..........#############.....######..######################....###########...#############............####
.............##################################........#############.....#####....####################......###########################...........###.
.........#....##################################......###############...######.....###################......############################..........####
...............##################################....#########################.....####################.....###############################.......####
..........#.....##################################..##########################.....####################.....#################################....#####
........###.....###############.##########################################.........####################......#########################...#####...####.
.......#####...###########################....##############...###...####..........#####################......########################....############
...######################################......############...........##...........####################.......#########..#############....############
..#############################...######.......############...........##...........#########.##########.......########...##############..############.
.#############################.....####........############..........###..........#########...########........########...############################.
.############################......####........#############........####.........##########....######.........########...#############################
.#######..##################.......###........###########################........####..####....######........#########...#############################
..#####......##############.......####.......###############################.....###...#####..#######............####....################...########.#
..#####........########...........####......#################################...###....##############.............###...##########.#####.....#########
..#####.........######...........####......#######################################....################............######################......########
..#####.........#####...........#####.....########################################....###############.............#######################.....#######.
.#######......#####.............####.....#########################################.....####.#########............#########################...#########
.#################.....#........###.....#####..####################################...#####.#########...........##############.######################.
.##################...###......###.....#####....#####################################################..........#######################################
.###################.#####....###.....#####.....######################################################........########################################
..#########################..#####...######....##########################################################....#####################################.###
...#######################################....##################################################################################...###############.###
....######################################...###############################################################################.###...###################
.....######################################.##########################################################################..##....########################
.....#################################.......########################################################################.........########################
....#################################.........###############...########...###.#####################################.........#############..##########
....################################............#############....#######...##########################..####.########......###############....#########
....################################.............###########......######...##########################..############........#############.....#########
....########......##################..............##########......#######..##########################..############.........############....##########
....#######.........#....############.............##########.....##################################################.........######...####..###########
....#######...............#.......####............###########....###################################################.........#####....################
...#########........#..............########.......###.#######....########################......###########################...#####....################
...###########.....................########......#############....######################........###################################..#################
..###############..................########.....##############.....####################.........######################..##############################
..################................#########....##############......#####################.......######################....############################.
..#################.........#.....##########..##############......#################################..###############.....#############################
..#####....########........##....##########################......#################################....#############......#############################
..####......#######.......####..###..#####################......#################################......########..........#############################
...###.......######.....##########....####################.....##################################.......######..........####...#######################
....##........######...#########.......####################..############################...#####........#####.........####.....###################..#
....###........################........#################################################.....#####.......######....#######.......#################....
....####........##############.............##############################################....#######....#################........#######.########....#
....#####.......#############...............###########################...################...############################.......#################...##
....######......############....................######################....################################################.....###################.###
...#########...#############.....................#####################....#######################.#########################################.##########
...####...##################......................###################.....###########################################################################.
...###.....########.....###........................##################.....###.#####...#####################################.....######################
............######..................................#################.....########.....###################################.......#####################
............######..................#..............##################.....########......#################################.........####################
............########.............#.######......#######################...#########.......################################...#......##################.
............##########.............#######....#####################################......#######.#########################..........##################
.............###########...........################################################.......#####...#####...#################.........##################
.............############..........######################..#########################......#####...####.....##################.......####.###..#######.
.###.........###############.......###########.....#####....########################......######.####.......##################......#######....#######
..##.........#################.....##########.......####....########################......###########........##################....#######......######
..##.........#.......##########...###########.......#####..############.......#######.....###########.........############################.......####.
..##..................#.....##################.....#################...........#######...###############.......##########...##############.......#####
.##..........................######################################............#########################........#########....##############......####.
.##............#..............####################################.............#########################..........#######.....##############....#####.
.###...........................##################################..............#########################...........#####.......#######################
.###.................###........#############################..##.............##########################...........#####.......##########..###########
.###.................###........###############..###########....##...........#####################...####..........#####.......#########....##########
.###.................###.........#####..######....##########....###..........####################.....##...........#####......##########....##########
.###......##........#####.........###....#####....##########....######.......####################.....##..........######.....############..####.....##
.###.....#####......#######........##....######..############..########......#########...########....##...........#######..###################.......#
.###......####.......######........###..###############################......########.....########..###..........############################........#
.###......#####.......#####........####################################......########.....#############.........#############################.......##
.###......######......######........################################..##....####.#####...#############.........##############################......###
.###......#######.....#####.........###############################....##..####...####################........###############################.....####
.####....#########...#####..........################..#############....########..#####################.......#################################...####.
.########################...........###############....#############..################################......#########################################.
.#######################............###############.....################...######################...###....###########################################
.#######.....############...........###........####.....################......########..########.....################################################.
.#######......###############.......##.........####......###############........#####....######......#########...###########.########.################
.#######......##################...###.........####.......###############........####......#...#....#########.....#########.########...###############
.#######......########################........#####........###############........###...........#############......#################...##############.
.#######......########################........#####........################.......###..........###############......#################.################
..######.....##############..#########........#####.........################......####......###################......#################################
...#####.....#############....#########......######..........################.....#####.....####################.....##########...####################
...#####.....###...######......#######.......#######...#......################...#######....#####################....######........##################.
...######...###.....####........######.......########..........##########################...######################..######..........#############....#
...#######.####..................#####.......#########..........##########################..##############################...........############.....
...#############.................####.......###########......#...#########################################################............###########.....
...##############................###.......#############.........####################..###########.########################...........################
...#################.............###......####....#######........###################....######################################........################
..#######################........###.....####......#######......###################.....########################################.......###############
..#######################.......####....####.........######....####################.....###########################################....##########...##
..######..###############......######..#####..........#############################.....###########################################.....########......
..#####....##############.....##############............###########################....#######.###################################.......#######......
..#####....###############...##############..............###########################..#######...########################...######.........######.....#
..#####....################################...............####...###########....#############....######################....#####...........#####.....#
..######...####.###########################...............###....##########......############.....####################....######...........#####....##
..######...###...##########################..............####....#########.......#############....##############...##....#######...........#####...###
.##.#####..###..#.#####.########.###.###.###.#####.###.#####.#..##########...#..#####..##.#.##.#..####...#######...#....##.##.#.#.#...#.#.##.##.#.####
